⬛🟩⬛⬛⬛⬛⬛⬛⬛⬛⬛
⬛🟧🟦🟦🟦🟦🟦🟦🟦🟦⬛
⬛🟧⬛⬛⬛🟦⬛🟦⬛⬛⬛
⬛🟧⬛🟦🟦🟦⬛🟦🟦🟦⬛
⬛🟧⬛⬛⬛⬛⬛⬛⬛⬛⬛
⬛🟧🟧🟧⬛🟦⬛🟦⬛🟦⬛
⬛⬛⬛🟧⬛🟦⬛🟦⬛🟦⬛
⬛🟦🟦🟧🟧🟧🟧🟧🟧🟧⬛
⬛🟦⬛🟦⬛⬛⬛🟦⬛🟧⬛
⬛🟦⬛🟦⬛🟦🟦🟦⬛🟧⬛
⬛⬛⬛⬛⬛⬛⬛⬛⬛🟥⬛
