⬛🟩⬛⬛⬛⬛⬛⬛⬛⬛⬛
⬛🟦🟦🟦🟦🟦🟦🟦🟦🟦⬛
⬛🟦⬛⬛⬛🟦⬛🟦⬛⬛⬛
⬛🟦⬛🟦🟦🟦⬛🟦🟦🟦⬛
⬛🟦⬛⬛⬛⬛⬛⬛⬛⬛⬛
⬛🟦🟦🟦⬛🟦⬛🟦⬛🟦⬛
⬛⬛⬛🟦⬛🟦⬛🟦⬛🟦⬛
⬛🟦🟦🟦🟦🟦🟦🟦🟦🟦⬛
⬛🟦⬛🟦⬛⬛⬛🟦⬛🟦⬛
⬛🟦⬛🟦⬛🟦🟦🟦⬛🟦⬛
⬛⬛⬛⬛⬛⬛⬛⬛⬛🟥⬛
